;NAME: Die Schlusskammer
;DESCRIPTION: Das Herz des Dungeons - überlebe wenn du kannst
##############################
#P............................#
#.############################
#.#...........................#
#.#.M.......T.................#
#.#...........................#
#.#.######.######.######......#
#.#.#    #.#    #.#    #......#
#.#.# M  #.# T  #.# M  #.....#
#.#.#    #.#    #.#    #.....#
#.#.######.######.######.....#
#.#...........................#
#.############################
#.............................#
#.....M......M......M.........#
#.............................#
#.############################
#.#...........................#
#.#.......T.......T...........#
#.#...........................#
#.#.M.......M.......M.........#
#.#...........................#
#.############################
#.............................#
##############################
